1.........
000.......
000.......
..........
..........
....000...
...00000..
...0...0..
.....A....